###########
####......#
###.......#
##..####..#
#...@..#..#
#....###..#
###..#....#
#.#......##
##........#
##.......##
###########