...########
####.####
.##.......#
##..####..#
#...@..#..#
###..###..#
###..#....#
.##......##
.#......##
.#.....##
###########